61
8
0 0 0 0 0 0 0 0 0 0 0 0 0 0 0 0 0 0 0 0 0 0 0 0 0 0 0 0 0 0 0 0 0 0 0 0 0 0 0 0 0 0 0 0 0 0 0 0 0 0 0 0 0 0 0 0 0 0 0 0 0 
0 0 0 0 0 0 0 0 0 0 0 0 0 0 0 0 0 0 0 0 0 0 0 0 0 0 0 0 0 0 0 0 0 0 0 0 0 0 0 0 13 0 0 0 0 0 0 0 0 0 0 0 0 0 0 0 0 0 0 0 0 
0 0 0 0 0 0 0 0 0 0 0 0 0 0 0 0 0 0 0 0 0 0 0 0 0 0 0 0 0 0 0 0 0 0 0 0 0 0 0 0 12 0 0 0 0 0 10 0 0 0 0 0 0 0 0 0 0 0 0 0 0 
0 0 0 0 0 0 0 0 0 0 0 0 0 0 0 0 0 0 0 0 0 0 0 0 0 13 0 0 0 0 0 0 0 0 0 0 0 0 0 0 11 0 1 0 8 20 22 7 0 0 0 0 0 0 0 0 0 0 0 0 0 
0 0 0 0 0 0 0 13 0 0 0 0 0 0 0 0 13 0 0 0 0 0 0 0 0 12 0 0 2 0 0 0 0 0 0 0 0 0 0 0 25 26 27 0 5 30 30 6 0 0 0 0 0 0 0 13 0 0 0 0 0 
0 0 0 0 0 0 0 12 0 0 0 0 1 0 0 0 12 0 0 0 0 0 1 0 2 11 4 20 22 3 10 0 0 0 0 0 0 0 0 0 0 0 0 0 15 30 30 6 0 0 0 0 0 0 0 12 0 0 0 0 0 
1 2 0 0 10 0 0 11 0 0 0 25 26 27 0 0 11 1 0 0 4 20 21 21 21 21 24 30 30 23 21 21 22 7 0 0 0 0 0 2 0 0 0 4 28 30 30 6 0 0 0 0 1 0 0 11 0 0 0 2 10 
21 21 21 21 21 21 21 21 21 27 0 0 0 0 0 25 21 21 21 21 24 30 30 30 30 30 30 30 30 30 30 30 30 6 0 0 25 21 21 21 21 21 24 28 30 30 30 6 0 8 20 21 21 21 21 21 21 21 21 21 21 
